1111111111111111111111111111111111111111111111111111111111111111
1000000000000000200000000000000110000000000012000000000000000001
1000000000000000200000000000000110000000000012000002222200000001
1000000000000000200000000000000110000000000002000002000200000001
1000000000000000200000000000000220000000000002000002333200000001
1000000000000000200000000000000220000000000002000002000200000001
1000000000000000200000000000000220000000000002000002222200000001
1300000000000000200000000000000220000000000012000000000000000001
1222222222222222200000000000000110000000000012222222222222222221
1000000000000000000000000000000110000000000011111111000011111111
1000000000000000000000000000000110000000000000000000000000000001
1000000000000000000000000000000110000000000000000000000000000001
1000000000030000000000000000000110000000000000000300000000000001
1000000000000000000000001111111111111111000000000000000000000001
1000000000000000000000000000000000000000000000000000000000000001
1000000000000000000000000000000000000000000000000000000000000001
1000000000000000000000000000000000000000000000000000000000000001
1000000000000000000000000000000000000000000000000000000000000001
1000000000000000000000000000000000000000000000000000000000000001
1000000000000000000000000000000000000000000000000000000000000001
1000000000000000000000000000000000000000000000000000000000000001
1000000000000000000000000000000000000000000000000000000000000001
1000000000000000000000000000000000000000000000000000000000000001
1000000000000000000000000000000000000000000000000000000000000001
1000000000000000000000000000000000000000000000000000000000000001
1000000000000000000000000000000000000000000000000000000000000001
1000000000000000000000000000000000000000000000000000000000000001
1000000000030000000000011111111111111111000000000300000000000001
1000000000000000000000022000011111000022000000000000000000000001
1000000000000000000000022000013331000022000000000000000000000001
1000000000000000000000022003013331030022000000000000000000000001
1000000000000000000000022000013331000022000000000000000000000001
1000000000000000000000022000011111000022000000000000000000000001
1000000000030000000000011111111111111111000000000300000000000001
1000000000000000000000000000000000000000000000000000000000000001
1000000000000000000000000000000000000000000000000000000000000001
1000000000000000000000000000000000000000000000000000000000000001
1000000000000000000000000000000000000000000000000000000000000001
1000000000000000000000000000000000000000000000000000000000000001
1000000000030000000000000000000000000000000000000300000000000001
1000000000000000000000000000000000000000000000000000000000000001
1000000000000000000000000000000000000000000000000000000000000001
1000000000000000000000000000000000000000000000000000000000000001
1000000000000000000000000000000000000000000000000000000000000001
1000000000000000000000000000000000000000000000000000000000000001
1000000000000000000000000000000000000000000000000000000000000001
1000000000000000000000000000000000000000000000000000000000000001
1000000000000000000000000000000000000000000000000000000000000001
1000000000000000000000000000000000000000000000000000000000000001
1000000000000000000000001111111111111111000000000000000000000001
1000000000000000000000000000000110000000000000000000000000000001
1000000000030000000000000000000110000000000000000300000000000001
1000000000000000000000000000000110000000000000000000000000000001
1111111100001111111110000000000110000000000000000000000000000001
1222222222222222222210000000000110000000000000222222222222222221
1000000000000000000210000000000220000000000000200000000000000031
1000000222220000000210000000000220000000000000200000000000000001
1000000200020000000200000000000220000000000000200000000000000001
1000000233320000000200000000000220000000000000200000000000000001
1000000200020000000200000000000220000000000000200000000000000001
1000000222220000000200000000000110000000000000200000000000000001
1000000000000000000210000000000110000000000000200000000000000001
1000000000000000000210000000000110000000000000200000000000000001
1111111111111111111111111111111111111111111111111111111111111111

